1 1 1 1 1 1 1 1 1 1 1 1 1
1 0 1 1 6 1 0 0 0 0 0 0 1
1 0 1 0 0 1 0 0 5 0 0 6 1
1 0 0 0 5 1 0 0 0 0 0 0 1
1 0 0 9 7 1 0 0 0 0 0 0 1
1 7 0 1 3 0 2 0 0 9 0 0 1
1 0 0 1 0 0 0 0 1 1 1 0 1
1 0 0 1 0 0 0 0 0 0 0 0 1
1 0 0 0 9 0 7 0 0 0 0 0 1
1 1 1 1 1 1 1 1 1 1 1 1 1
